1111111111111111
1701000100000004
1011010100000109
1000020010011111
1011110010310001
1010010810010101
1010011111000101
1010000000000101
1010100001000101
1011011110111101
1000000000002001
1111111111111111